**************************          **************************
**************************          **************************
**************************          **************************
**************************          **************************
**************************          **************************
**********                                          **********
**********  --                                  --  **********
**********                                          **********
**********      11********          **********      **********
**********      **********          **********      **********
**********      **********          **********      **********
**********      **********          **********      **********
**********      **********          **********      **********
                                                              
                                                              
                              ++                              
                                                              
                                                              
**********      **********          **********      **********
**********      **********          **********      **********
**********      **********          **********      **********
**********      **********          **********      **********
**********      **********          **********      **********
**********                                          **********
**********                                          **********
**********                                          **********
**************************          **************************
**************************          **************************
**************************          **************************
**************************          **************************
**************************          **************************