\*\*\*\*\*\*\*\*\*\*\*\*\*          \*\*\*\*\*\*\*\*\*\*\*\*\*
\*\*\*\*\*\*\*\*\*\*\*\*\*          \*\*\*\*\*\*\*\*\*\*\*\*\*
\*\*\*\*\*\*\*\*\*\*\*\*\*          \*\*\*\*\*\*\*\*\*\*\*\*\*
\*\*\*\*\*\*\*\*\*\*\*\*\*          \*\*\*\*\*\*\*\*\*\*\*\*\*
\*\*\*\*\*\*\*\*\*\*\*\*\*          \*\*\*\*\*\*\*\*\*\*\*\*\*
\*\*\*\*\*                                          \*\*\*\*\*
\*\*\*\*\*  \-                                  \-  \*\*\*\*\*
\*\*\*\*\*                                          \*\*\*\*\*
\*\*\*\*\*      \1\*\*\*\*          \*\*\*\*\*      \*\*\*\*\*
\*\*\*\*\*      \*\*\*\*\*          \*\*\*\*\*      \*\*\*\*\*
\*\*\*\*\*      \*\*\*\*\*          \*\*\*\*\*      \*\*\*\*\*
\*\*\*\*\*      \*\*\*\*\*          \*\*\*\*\*      \*\*\*\*\*
\*\*\*\*\*      \*\*\*\*\*          \*\*\*\*\*      \*\*\*\*\*
                                                              
                                                              
                              \+                              
                                                              
                                                              
\*\*\*\*\*      \*\*\*\*\*          \*\*\*\*\*      \*\*\*\*\*
\*\*\*\*\*      \*\*\*\*\*          \*\*\*\*\*      \*\*\*\*\*
\*\*\*\*\*      \*\*\*\*\*          \*\*\*\*\*      \*\*\*\*\*
\*\*\*\*\*      \*\*\*\*\*          \*\*\*\*\*      \*\*\*\*\*
\*\*\*\*\*      \*\*\*\*\*          \*\*\*\*\*      \*\*\*\*\*
\*\*\*\*\*                                          \*\*\*\*\*
\*\*\*\*\*                                          \*\*\*\*\*
\*\*\*\*\*                                          \*\*\*\*\*
\*\*\*\*\*\*\*\*\*\*\*\*\*          \*\*\*\*\*\*\*\*\*\*\*\*\*
\*\*\*\*\*\*\*\*\*\*\*\*\*          \*\*\*\*\*\*\*\*\*\*\*\*\*
\*\*\*\*\*\*\*\*\*\*\*\*\*          \*\*\*\*\*\*\*\*\*\*\*\*\*
\*\*\*\*\*\*\*\*\*\*\*\*\*          \*\*\*\*\*\*\*\*\*\*\*\*\*
\*\*\*\*\*\*\*\*\*\*\*\*\*          \*\*\*\*\*\*\*\*\*\*\*\*\*